11111111111111111
1C00000C000000001
100010E0110000001
1P00100000C000001
11111111111111111
